1111111
1P0C0E1
1P00001
1111111