P000C0E11
000000001
C00000000
100000000
110011111