9 . o x
...........................
....o......................
............o..............
.........................o.
....o....o........o........
......o....o...o...........
...........................
......o..............o.....
..o.......o................
