111111111
1P0000001
101111101
10C000001
111111111
1000000E1
111111111