111111111
1P0000001
111111101
10C100001
111111101
1000000E1
111111111