1111111111
1P00000C01
1011111011
10C0010001
1111011101
1000010C01
1011111011
100C0000E1
1111111111