111111111111111
100000000C00001
101111111110101
1P0000000000C01
101011C01111101
100010000010001
111010111C10101
1000100000100E1
111111111111111